"a" = (/turf/open/floor/rogue/grass,/area/rogue/outdoors)
"b" = (/obj/structure/arcyne_wall/greater/caster,/turf/open/floor/rogue/greenstone,/area/rogue/outdoors)
"c" = (/turf/open/floor/rogue/greenstone,/area/rogue/outdoors)
"d" = (/obj/structure/mineral_door/wood/deadbolt/arcyne/caster{dir = 8},/turf/open/floor/rogue/greenstone,/area/rogue/outdoors)
"e" = (/turf/open/floor/rogue/greenstone/runed,/area/rogue/outdoors)
"f" = (/obj/structure/mineral_door/wood/deadbolt/arcyne/caster{dir = 4},/turf/open/floor/rogue/greenstone,/area/rogue/outdoors)
"g" = (/obj/structure/mineral_door/wood/deadbolt/arcyne/caster,/turf/open/floor/rogue/greenstone,/area/rogue/outdoors)
"h" = (/obj/machinery/light/rogue/wallfire/candle/blue/l,/turf/open/floor/rogue/greenstone,/area/rogue/outdoors)
"i" = (/obj/machinery/light/rogue/firebowl/standing/blue,/turf/open/floor/rogue/greenstone,/area/rogue/outdoors)
"j" = (/obj/machinery/light/rogue/wallfire/candle/blue/r,/turf/open/floor/rogue/greenstone,/area/rogue/outdoors)
"k" = (/obj/machinery/light/rogue/wallfire/candle/blue/r,/turf/open/floor/rogue/greenstone/runed,/area/rogue/outdoors)

(1,1,1) = {"
abbbbbbbbbbba
bbcceccecccbb
bcebbbbbbbecb
bhbbieeeibbjb
bebcecececbcb
bcbecceccebeb
gcfcccecccdcd
bcbcceeeccbcb
bebcccecccbcb
bhbbicecibbkb
bcebbbbbbbecb
bbceccececcbb
abbbbbbbbbbba
"}
