//MAP CONVERTED BY dmm2tgm.py THIS HEADER COMMENT PREVENTS RECONVERSION, DO NOT REMOVE
"a" = (
/turf/open/floor/rogue/blocks/green,
/area/rogue)
"c" = (
/obj/structure/roguemachine/stockpile,
/turf/open/floor/rogue/blocks/green,
/area/rogue)
"d" = (
/obj/structure/roguemachine/seedmachine,
/turf/open/floor/rogue/blocks/green,
/area/rogue)
"e" = (
/obj/machinery/light/rogue/torchholder/c,
/turf/open/floor/rogue/blocks/green,
/area/rogue)
"f" = (
/turf/open/floor/rogue/blocks/bluestone,
/area/rogue/indoors/town/vault)
"h" = (
/obj/machinery/light/rogue/torchholder/r,
/turf/open/floor/rogue/blocks/green,
/area/rogue)
"i" = (
/obj/structure/roguemachine/drugmachine,
/turf/open/floor/rogue/blocks/green,
/area/rogue)
"l" = (
/obj/structure/handcart,
/turf/open/floor/rogue/blocks/green,
/area/rogue)
"m" = (
/obj/effect/landmark/start/adventurer,
/turf/open/floor/rogue/blocks/bluestone,
/area/rogue)
"p" = (
/obj/machinery/light/rogue/torchholder{
	dir = 1
	},
/turf/open/floor/rogue/blocks/green,
/area/rogue)
"q" = (
/obj/item/roguemachine/mastermail,
/turf/open/floor/rogue/blocks/green,
/area/rogue)
"t" = (
/obj/structure/roguemachine/steward,
/turf/open/floor/rogue/blocks/green,
/area/rogue)
"u" = (
/obj/effect/landmark/start/adventurer,
/obj/machinery/light/rogue/torchholder/l,
/turf/open/floor/rogue/blocks/bluestone,
/area/rogue)
"z" = (
/turf/closed/indestructible/riveted,
/area/rogue)
"A" = (
/turf/open/floor/rogue/blocks/bluestone,
/area/rogue)
"B" = (
/obj/structure/roguemachine/mail,
/turf/open/floor/rogue/blocks/green,
/area/rogue)
"F" = (
/obj/machinery/light/rogue/torchholder/l,
/turf/open/floor/rogue/blocks/green,
/area/rogue)
"G" = (
/obj/effect/landmark/start/adventurerlate,
/turf/open/floor/rogue/blocks/bluestone,
/area/rogue)
"H" = (
/obj/structure/feedinghole,
/turf/open/floor/rogue/blocks/green,
/area/rogue)
"K" = (
/obj/structure/roguemachine/merchantvend,
/turf/open/floor/rogue/blocks/green,
/area/rogue)
"L" = (
/obj/machinery/light/rogue/torchholder/r,
/obj/structure/roguemachine/balloon_pad,
/turf/open/floor/rogue/blocks/bluestone,
/area/rogue)
"M" = (
/obj/structure/roguemachine/vendor/inn,
/turf/open/floor/rogue/blocks/green,
/area/rogue)
"N" = (
/obj/structure/roguemachine/bounty,
/obj/machinery/light/rogue/torchholder/c,
/turf/open/floor/rogue/blocks/green,
/area/rogue)
"Q" = (
/obj/structure/roguemachine/scomm,
/turf/open/floor/rogue/blocks/green,
/area/rogue)
"S" = (
/obj/effect/landmark/latejoin,
/turf/open/floor/rogue/blocks/bluestone,
/area/rogue)
"T" = (
/obj/structure/roguemachine/atm,
/turf/open/floor/rogue/blocks/green,
/area/rogue)
"V" = (
/obj/item/roguemachine/merchant,
/obj/machinery/light/rogue/torchholder/c,
/turf/open/floor/rogue/blocks/green,
/area/rogue)
"W" = (
/obj/structure/roguemachine/balloon_pad,
/turf/open/floor/rogue/blocks/bluestone,
/area/rogue)
"Z" = (
/obj/structure/roguemachine/withdraw,
/turf/open/floor/rogue/blocks/green,
/area/rogue)

(1,1,1) = {"
z
z
z
z
z
z
z
z
z
z
z
z
z
z
z
z
z
z
z
z
z
z
z
z
z
"}
(2,1,1) = {"
z
m
G
u
G
m
F
a
a
a
a
a
F
a
a
a
a
a
F
A
A
A
A
A
z
"}
(3,1,1) = {"
z
G
G
m
G
m
a
a
a
a
a
a
a
a
a
a
a
a
a
A
A
A
A
A
z
"}
(4,1,1) = {"
z
m
m
S
G
m
a
a
a
a
a
a
a
a
a
a
a
a
a
A
A
A
A
A
z
"}
(5,1,1) = {"
z
G
G
G
G
m
a
a
a
a
a
a
a
a
a
a
a
a
a
A
A
A
A
A
z
"}
(6,1,1) = {"
z
m
m
m
m
m
h
a
a
a
a
a
a
a
a
a
a
a
h
A
A
A
A
A
z
"}
(7,1,1) = {"
z
t
a
h
a
a
z
a
a
a
a
a
a
a
a
a
a
a
z
a
a
a
a
p
z
"}
(8,1,1) = {"
z
T
a
z
c
a
F
a
a
a
a
a
a
a
a
a
a
a
F
a
a
a
a
a
z
"}
(9,1,1) = {"
z
N
a
F
a
a
a
a
a
a
a
a
a
a
a
a
a
a
a
a
a
a
a
a
z
"}
(10,1,1) = {"
z
i
a
l
a
a
a
a
a
a
h
a
a
a
h
a
a
a
a
a
a
a
a
a
z
"}
(11,1,1) = {"
z
B
a
a
a
a
a
a
a
a
z
a
z
a
z
a
a
a
a
a
a
a
a
a
z
"}
(12,1,1) = {"
z
K
a
z
H
a
a
a
a
a
a
f
f
f
a
a
a
a
a
a
a
a
a
a
z
"}
(13,1,1) = {"
z
e
a
z
Q
a
a
a
a
p
z
f
f
f
z
e
a
a
a
a
a
a
a
p
z
"}
(14,1,1) = {"
z
d
a
a
a
a
a
a
a
a
a
f
f
f
a
a
a
a
a
a
a
a
a
a
z
"}
(15,1,1) = {"
z
M
a
h
a
a
a
a
a
a
z
a
z
a
z
a
a
a
a
a
a
a
a
a
z
"}
(16,1,1) = {"
z
Z
a
z
z
a
a
a
a
a
F
a
a
a
F
a
a
a
a
a
a
a
a
a
z
"}
(17,1,1) = {"
z
V
a
a
z
a
a
a
a
a
a
a
a
a
a
a
a
a
a
a
a
a
a
a
z
"}
(18,1,1) = {"
z
q
a
z
z
a
h
a
a
a
a
a
a
a
a
a
a
a
h
a
a
a
a
a
z
"}
(19,1,1) = {"
z
a
a
F
a
a
z
a
a
a
a
a
a
a
a
a
a
a
z
a
a
a
a
p
z
"}
(20,1,1) = {"
z
W
W
W
W
W
F
a
a
a
a
a
a
a
a
a
a
a
F
A
A
A
A
A
z
"}
(21,1,1) = {"
z
W
W
W
W
W
a
a
a
a
a
a
a
a
a
a
a
a
a
A
A
A
A
A
z
"}
(22,1,1) = {"
z
W
W
W
W
W
a
a
a
a
a
a
a
a
a
a
a
a
a
A
A
A
A
A
z
"}
(23,1,1) = {"
z
W
W
W
W
W
a
a
a
a
a
a
a
a
a
a
a
a
a
A
A
A
A
A
z
"}
(24,1,1) = {"
z
W
W
L
W
W
h
a
a
a
a
a
h
a
a
a
a
a
h
A
A
A
A
A
z
"}
(25,1,1) = {"
z
z
z
z
z
z
z
z
z
z
z
z
z
z
z
z
z
z
z
z
z
z
z
z
z
"}
