//MAP CONVERTED BY dmm2tgm.py THIS HEADER COMMENT PREVENTS RECONVERSION, DO NOT REMOVE
"b" = (
/turf/open/floor/plating/dirt/dark,
/area/rogue/underworld)
"c" = (
/obj/effect/landmark/underworldsafe,
/turf/open/floor/plating/dirt/dark,
/area/rogue/underworld)
"d" = (
/obj/effect/landmark/underworldsafe,
/turf/open/floor/rogue/underworld/road,
/area/rogue/underworld)
"e" = (
/turf/open/floor/rogue/underworld/road,
/area/rogue/underworld)
"f" = (
/obj/structure/underworld/barrier,
/turf/open/floor/rogue/churchrough,
/area/rogue/underworld)
"g" = (
/obj/structure/underworld/carriage{
	pixel_x = -100
	},
/turf/open/floor/rogue/churchrough,
/area/rogue/underworld)
"h" = (
/obj/structure/bed/rogue/shit,
/turf/open/floor/rogue/underworld/road,
/area/rogue/underworld)
"i" = (
/obj/effect/landmark/underworldcoin,
/turf/open/floor/rogue/underworld/road,
/area/rogue/underworld)
"j" = (
/obj/structure/underworld/carriageman{
	pixel_x = -15;
	pixel_y = -20
	},
/obj/structure/underworld/barrier,
/turf/open/floor/rogue/underworld/road,
/area/rogue/underworld)
"k" = (
/turf/open/floor/rogue/churchrough,
/area/rogue/underworld)
"l" = (
/obj/structure/underworld/barrier,
/turf/open/floor/plating/dirt/dark,
/area/rogue/underworld)
"n" = (
/obj/structure/flora/roguetree/underworld,
/turf/open/floor/rogue/underworld/road,
/area/rogue/underworld)
"o" = (
/obj/machinery/light/rogue/campfire/densefire{
	fueluse = 1800000
	},
/turf/open/floor/rogue/underworld/road,
/area/rogue/underworld)
"p" = (
/obj/structure/fluff/clock,
/turf/open/floor/rogue/underworld/road,
/area/rogue/underworld)
"u" = (
/obj/structure/flora/roguetree/underworld,
/obj/structure/flora/roguetree/underworld,
/turf/open/floor/rogue/underworld/road,
/area/rogue/underworld)
"G" = (
/obj/structure/bed/rogue/shit,
/obj/effect/landmark/underworld,
/turf/open/floor/rogue/underworld/road,
/area/rogue/underworld)

(1,1,1) = {"
e
d
c
c
c
d
n
n
n
n
n
n
n
e
n
n
e
n
"}
(2,1,1) = {"
d
e
b
b
b
e
n
n
n
n
n
n
e
n
n
n
u
e
"}
(3,1,1) = {"
d
e
b
b
b
e
n
e
e
e
e
e
e
e
e
e
e
n
"}
(4,1,1) = {"
d
e
b
b
b
e
n
e
e
e
e
e
e
e
e
e
e
e
"}
(5,1,1) = {"
d
e
b
b
b
b
n
e
e
e
e
e
e
e
e
e
e
e
"}
(6,1,1) = {"
d
e
b
b
b
b
n
e
e
e
e
e
e
e
e
e
e
e
"}
(7,1,1) = {"
d
b
b
b
b
b
n
e
e
e
e
e
e
e
h
e
e
e
"}
(8,1,1) = {"
d
b
b
b
b
b
e
e
e
o
e
e
e
e
e
e
e
e
"}
(9,1,1) = {"
d
b
b
l
l
b
e
e
e
p
e
e
e
h
o
e
e
e
"}
(10,1,1) = {"
d
b
b
l
f
k
k
k
k
k
e
e
e
e
G
e
e
e
"}
(11,1,1) = {"
d
b
b
l
g
k
k
k
k
k
e
e
e
e
e
e
e
e
"}
(12,1,1) = {"
d
b
b
l
l
b
e
e
e
e
e
e
e
e
e
e
e
e
"}
(13,1,1) = {"
d
b
b
l
b
b
n
e
e
o
e
e
e
e
e
e
e
n
"}
(14,1,1) = {"
d
b
b
b
b
b
n
i
e
e
e
e
e
e
e
e
n
n
"}
(15,1,1) = {"
d
c
b
b
b
b
n
e
j
e
e
e
e
e
e
e
n
n
"}
(16,1,1) = {"
e
c
b
b
b
b
n
e
e
e
n
n
n
n
n
n
n
e
"}
(17,1,1) = {"
e
c
b
b
b
e
n
e
e
e
n
n
n
e
e
e
n
e
"}
(18,1,1) = {"
e
c
b
b
b
e
n
n
n
n
n
e
e
e
n
e
e
e
"}
(19,1,1) = {"
e
c
b
b
b
e
n
n
n
n
n
e
n
n
e
n
e
e
"}
(20,1,1) = {"
e
c
c
c
c
d
n
e
e
e
e
e
n
n
e
e
e
e
"}
