//MAP CONVERTED BY dmm2tgm.py THIS HEADER COMMENT PREVENTS RECONVERSION, DO NOT REMOVE
"a" = (
/turf/closed/mineral/rogue,
/area/rogue/under/town/sewer)
"b" = (
/obj/structure/spider/stickyweb,
/turf/open/floor/rogue/greenstone,
/area/rogue/under/town/sewer)
"f" = (
/mob/living/simple_animal/hostile/retaliate/rogue/bigrat,
/turf/open/water/swamp/deep,
/area/rogue/under/town/sewer)
"i" = (
/mob/living/simple_animal/hostile/retaliate/rogue/bigrat,
/turf/open/floor/rogue/greenstone,
/area/rogue/under/town/sewer)
"j" = (
/obj/effect/decal/cleanable/cobweb,
/obj/effect/spawner/lootdrop/roguetown/sewers,
/turf/open/water/swamp/deep,
/area/rogue/under/town/sewer)
"o" = (
/obj/structure/glowshroom,
/turf/open/floor/rogue/greenstone,
/area/rogue/under/town/sewer)
"p" = (
/obj/structure/glowshroom,
/turf/open/water/swamp/deep,
/area/rogue/under/town/sewer)
"t" = (
/turf/open/water/swamp/deep,
/area/rogue/under/town/sewer)
"v" = (
/obj/structure/spider/stickyweb,
/turf/open/water/swamp/deep,
/area/rogue/under/town/sewer)
"w" = (
/mob/living/carbon/human/species/human/northern/bum,
/turf/open/floor/rogue/greenstone,
/area/rogue/under/town/sewer)
"x" = (
/mob/living/simple_animal/hostile/retaliate/rogue/bigrat,
/turf/open/water/sewer,
/area/rogue/under/town/sewer)
"y" = (
/obj/structure/spider/stickyweb,
/turf/open/water/swamp,
/area/rogue/under/town/sewer)
"z" = (
/obj/machinery/light/rogue/torchholder,
/turf/closed/wall/mineral/rogue/stonebrick,
/area/rogue/under/town/sewer)
"E" = (
/obj/structure/bars,
/turf/open/water/sewer,
/area/rogue/under/town/sewer)
"F" = (
/turf/closed/wall/mineral/rogue/stonebrick,
/area/rogue/under/town/sewer)
"H" = (
/obj/effect/spawner/lootdrop/roguetown/sewers,
/turf/open/water/swamp/deep,
/area/rogue/under/town/sewer)
"J" = (
/obj/structure/spider/stickyweb,
/turf/open/water/sewer,
/area/rogue/under/town/sewer)
"K" = (
/turf/open/floor/rogue/greenstone,
/area/rogue/under/town/sewer)
"L" = (
/obj/structure/bars,
/turf/open/water/swamp,
/area/rogue/under/town/sewer)
"M" = (
/turf/open/water/sewer,
/area/rogue/under/town/sewer)
"P" = (
/obj/effect/decal/cleanable/ash/large,
/turf/closed/mineral/rogue,
/area/rogue/under/town/sewer)
"Q" = (
/turf/open/water/swamp,
/area/rogue/under/town/sewer)

(1,1,1) = {"
F
a
a
a
a
a
a
a
a
a
a
a
a
a
a
a
a
a
"}
(2,1,1) = {"
F
a
a
a
a
a
F
F
F
F
a
a
F
F
F
F
a
a
"}
(3,1,1) = {"
F
a
a
a
a
a
F
j
t
F
F
F
F
H
t
F
a
a
"}
(4,1,1) = {"
F
a
a
a
a
a
F
t
p
t
t
f
t
t
t
F
F
a
"}
(5,1,1) = {"
F
a
a
a
a
a
F
H
p
H
t
v
t
p
t
H
F
a
"}
(6,1,1) = {"
F
a
a
a
a
a
a
F
Q
Q
p
v
v
t
p
t
F
a
"}
(7,1,1) = {"
F
a
a
a
a
a
a
F
Q
y
y
Q
p
t
v
t
F
a
"}
(8,1,1) = {"
F
F
F
F
F
F
F
F
L
L
Q
Q
Q
t
H
F
F
a
"}
(9,1,1) = {"
K
b
K
w
K
K
K
b
J
M
M
Q
y
v
F
F
a
a
"}
(10,1,1) = {"
J
J
M
M
M
M
M
M
M
M
M
E
y
Q
F
a
a
a
"}
(11,1,1) = {"
M
M
M
M
M
M
M
M
M
M
K
E
Q
F
F
a
a
a
"}
(12,1,1) = {"
K
i
K
o
o
K
K
K
K
M
K
F
F
F
a
a
a
a
"}
(13,1,1) = {"
F
F
F
F
F
F
F
F
K
M
w
F
a
a
a
a
a
a
"}
(14,1,1) = {"
F
a
a
a
a
a
a
F
K
M
K
F
a
a
a
a
a
a
"}
(15,1,1) = {"
F
a
a
a
a
a
a
F
K
M
K
F
a
a
a
a
a
a
"}
(16,1,1) = {"
F
a
a
a
a
a
a
F
K
M
K
F
a
a
a
a
a
a
"}
(17,1,1) = {"
F
a
a
a
a
a
a
F
K
J
K
F
a
a
a
a
a
a
"}
(18,1,1) = {"
F
a
a
a
a
a
a
F
b
x
K
F
a
a
a
a
a
a
"}
(19,1,1) = {"
F
a
a
a
a
a
a
F
b
M
K
F
a
a
a
a
a
a
"}
(20,1,1) = {"
F
a
a
a
a
a
a
F
K
J
K
F
a
a
a
a
a
a
"}
(21,1,1) = {"
F
a
a
a
a
a
a
F
K
M
K
F
a
a
a
a
a
a
"}
(22,1,1) = {"
F
a
a
a
a
a
a
F
w
M
K
F
a
a
a
P
a
a
"}
(23,1,1) = {"
F
a
a
a
a
a
a
F
K
M
o
F
a
a
a
a
a
a
"}
(24,1,1) = {"
F
a
a
a
a
a
a
F
K
M
o
F
a
a
a
a
a
a
"}
(25,1,1) = {"
F
a
a
a
a
a
a
F
K
M
K
F
a
a
a
a
a
a
"}
(26,1,1) = {"
F
F
F
F
F
F
F
F
K
M
K
F
F
F
F
F
F
z
"}
