//MAP CONVERTED BY dmm2tgm.py THIS HEADER COMMENT PREVENTS RECONVERSION, DO NOT REMOVE
"a" = (
/turf/closed/wall/mineral/rogue/stonebrick,
/area/rogue/under/town/sewer)
"b" = (
/turf/open/water/swamp,
/area/rogue/under/town/sewer)
"d" = (
/obj/structure/fluff/walldeco/chains,
/mob/living/carbon/human/species/skeleton/npc,
/turf/open/water/swamp/deep,
/area/rogue/under/town/sewer)
"f" = (
/obj/structure/glowshroom,
/turf/open/water/swamp,
/area/rogue/under/town/sewer)
"j" = (
/obj/effect/decal/cleanable/cobweb,
/obj/structure/fluff/walldeco/chains,
/turf/open/floor/rogue/cobble,
/area/rogue/under/town/sewer)
"l" = (
/mob/living/carbon/human/species/skeleton/npc,
/turf/open/floor/rogue/cobble,
/area/rogue/under/town/sewer)
"v" = (
/obj/structure/spider/stickyweb,
/obj/structure/spider/stickyweb,
/turf/open/floor/rogue/cobble,
/area/rogue/under/town/sewer)
"w" = (
/obj/machinery/light/rogue/torchholder,
/turf/closed/wall/mineral/rogue/stonebrick,
/area/rogue/under/town/sewer)
"x" = (
/obj/structure/spider/stickyweb,
/turf/open/floor/rogue/cobble,
/area/rogue/under/town/sewer)
"y" = (
/turf/closed/mineral/rogue,
/area/rogue/under/town/sewer)
"z" = (
/turf/open/floor/rogue/cobble,
/area/rogue/under/town/sewer)
"A" = (
/obj/effect/decal/cleanable/cobweb,
/obj/structure/closet/crate/chest,
/obj/effect/spawner/lootdrop/roguetown/sewers,
/turf/open/floor/rogue/cobble,
/area/rogue/under/town/sewer)
"B" = (
/obj/structure/fluff/walldeco/chains,
/turf/open/floor/rogue/cobble,
/area/rogue/under/town/sewer)
"G" = (
/obj/structure/closet/crate/chest,
/obj/effect/spawner/lootdrop/roguetown/sewers,
/turf/open/floor/rogue/cobble,
/area/rogue/under/town/sewer)
"K" = (
/obj/structure/spider/stickyweb,
/turf/open/water/swamp,
/area/rogue/under/town/sewer)
"L" = (
/obj/structure/glowshroom,
/turf/open/floor/rogue/cobble,
/area/rogue/under/town/sewer)
"M" = (
/obj/effect/decal/cleanable/ash/large,
/turf/open/water/swamp/deep,
/area/rogue/under/town/sewer)
"O" = (
/obj/structure/glowshroom,
/turf/open/water/swamp/deep,
/area/rogue/under/town/sewer)
"R" = (
/obj/structure/rack/rogue,
/obj/effect/spawner/lootdrop/roguetown/sewers,
/turf/open/floor/rogue/cobble,
/area/rogue/under/town/sewer)
"S" = (
/turf/open/water/swamp/deep,
/area/rogue/under/town/sewer)
"T" = (
/obj/effect/decal/remains/human,
/turf/open/floor/rogue/cobble,
/area/rogue/under/town/sewer)
"U" = (
/obj/structure/fluff/walldeco/chains,
/turf/open/water/swamp,
/area/rogue/under/town/sewer)

(1,1,1) = {"
a
y
y
y
y
y
a
a
a
a
a
a
a
a
a
a
a
a
"}
(2,1,1) = {"
a
y
y
y
y
y
a
A
z
z
z
S
O
S
S
S
S
a
"}
(3,1,1) = {"
a
y
y
y
y
y
a
z
z
l
b
z
S
S
S
S
S
a
"}
(4,1,1) = {"
a
y
y
y
y
y
a
L
b
b
b
a
T
S
O
S
S
a
"}
(5,1,1) = {"
a
y
y
y
y
y
a
z
z
b
b
a
z
S
S
S
G
a
"}
(6,1,1) = {"
a
y
y
y
y
y
a
R
b
f
b
z
z
S
S
S
z
a
"}
(7,1,1) = {"
a
y
y
y
y
y
a
R
b
b
b
z
z
S
O
S
S
a
"}
(8,1,1) = {"
a
a
a
y
y
y
a
B
b
b
b
b
z
S
S
S
S
a
"}
(9,1,1) = {"
z
x
a
a
y
y
a
B
z
b
b
b
z
S
S
S
S
a
"}
(10,1,1) = {"
x
x
z
a
a
y
a
z
z
a
a
b
z
S
O
S
S
a
"}
(11,1,1) = {"
z
L
K
b
a
a
a
z
b
b
b
b
l
S
S
S
S
a
"}
(12,1,1) = {"
a
a
a
x
v
x
f
z
b
f
b
b
b
S
S
S
S
a
"}
(13,1,1) = {"
a
y
a
f
v
v
b
b
b
b
z
b
b
O
S
S
S
a
"}
(14,1,1) = {"
a
y
a
a
b
x
x
z
z
b
z
z
a
S
S
S
S
a
"}
(15,1,1) = {"
a
y
y
a
U
x
b
b
b
b
z
b
b
S
S
S
S
a
"}
(16,1,1) = {"
a
y
y
a
T
v
b
b
b
f
b
b
b
S
S
S
z
a
"}
(17,1,1) = {"
a
y
y
a
a
a
a
a
a
L
b
b
b
S
S
G
z
a
"}
(18,1,1) = {"
a
y
y
y
y
y
y
a
a
b
b
b
z
S
O
S
T
a
"}
(19,1,1) = {"
a
y
y
y
y
y
a
a
j
b
L
a
S
S
O
S
S
a
"}
(20,1,1) = {"
a
y
y
y
y
a
a
R
z
b
a
S
S
S
S
S
S
a
"}
(21,1,1) = {"
a
y
y
y
a
a
x
K
b
z
z
S
S
S
S
S
S
a
"}
(22,1,1) = {"
a
y
y
y
a
z
x
f
b
z
z
S
O
S
S
M
S
a
"}
(23,1,1) = {"
a
y
y
a
a
K
b
x
x
z
a
a
a
a
a
a
d
a
"}
(24,1,1) = {"
a
y
y
a
f
K
b
a
a
a
a
y
y
y
y
a
a
a
"}
(25,1,1) = {"
a
y
a
a
x
x
a
y
y
y
y
y
y
y
y
y
y
y
"}
(26,1,1) = {"
a
a
a
z
x
z
a
a
a
a
a
a
a
a
a
a
a
w
"}
