//MAP CONVERTED BY dmm2tgm.py THIS HEADER COMMENT PREVENTS RECONVERSION, DO NOT REMOVE
"a" = (
/turf/closed/mineral/rogue,
/area/rogue/under/town/sewer)
"i" = (
/turf/closed/wall/mineral/rogue/stonebrick,
/area/rogue/under/town/sewer)
"j" = (
/obj/structure/spider/stickyweb,
/turf/open/water/sewer,
/area/rogue/under/town/sewer)
"w" = (
/obj/effect/decal/remains/human,
/obj/effect/decal/remains/xeno/larva,
/turf/open/floor/rogue/greenstone,
/area/rogue/under/town/sewer)
"C" = (
/obj/structure/glowshroom,
/turf/open/floor/rogue/greenstone,
/area/rogue/under/town/sewer)
"D" = (
/obj/structure/spider/stickyweb,
/turf/open/floor/rogue/greenstone,
/area/rogue/under/town/sewer)
"J" = (
/mob/living/carbon/human/species/human/northern/bum,
/turf/open/floor/rogue/greenstone,
/area/rogue/under/town/sewer)
"P" = (
/mob/living/simple_animal/hostile/retaliate/rogue/bigrat,
/turf/open/floor/rogue/greenstone,
/area/rogue/under/town/sewer)
"Q" = (
/turf/open/floor/rogue/greenstone,
/area/rogue/under/town/sewer)
"R" = (
/turf/open/water/sewer,
/area/rogue/under/town/sewer)
"S" = (
/obj/structure/glowshroom,
/turf/open/water/sewer,
/area/rogue/under/town/sewer)
"T" = (
/obj/effect/spawner/lootdrop/roguetown/sewers,
/turf/open/floor/rogue/greenstone,
/area/rogue/under/town/sewer)
"X" = (
/mob/living/simple_animal/hostile/retaliate/rogue/bigrat,
/turf/open/water/sewer,
/area/rogue/under/town/sewer)

(1,1,1) = {"
i
i
i
i
i
P
R
Q
i
i
i
i
i
i
i
i
i
i
i
i
i
"}
(2,1,1) = {"
i
a
a
a
i
Q
R
Q
i
a
a
a
a
a
a
a
a
a
a
a
i
"}
(3,1,1) = {"
i
a
a
a
i
Q
R
Q
i
a
a
a
a
a
a
a
a
a
a
a
i
"}
(4,1,1) = {"
i
a
a
a
i
Q
R
J
i
a
a
a
a
a
a
a
a
a
a
a
i
"}
(5,1,1) = {"
i
a
a
a
i
D
R
Q
i
i
i
i
i
i
i
i
i
i
i
i
i
"}
(6,1,1) = {"
i
a
a
a
i
Q
R
Q
Q
Q
Q
Q
Q
Q
Q
Q
C
Q
Q
Q
P
"}
(7,1,1) = {"
i
a
a
a
i
Q
R
S
R
R
j
X
j
R
S
S
j
R
R
R
R
"}
(8,1,1) = {"
i
a
a
a
i
T
R
R
S
R
R
j
R
R
S
j
R
R
R
R
R
"}
(9,1,1) = {"
i
a
a
a
i
w
R
Q
Q
Q
Q
Q
Q
J
Q
Q
Q
Q
Q
Q
Q
"}
(10,1,1) = {"
i
a
a
a
i
Q
R
Q
i
i
i
i
i
i
i
i
i
i
i
i
i
"}
(11,1,1) = {"
i
a
a
a
i
J
R
Q
i
a
a
a
a
a
a
a
a
a
a
a
i
"}
(12,1,1) = {"
i
a
a
a
i
Q
S
Q
i
a
a
a
a
a
a
a
a
a
a
a
i
"}
(13,1,1) = {"
i
a
a
a
i
Q
S
Q
i
a
a
a
a
a
a
a
a
a
a
a
i
"}
(14,1,1) = {"
i
i
i
i
i
P
j
D
i
i
i
i
i
i
i
i
i
i
i
i
i
"}
