//MAP CONVERTED BY dmm2tgm.py THIS HEADER COMMENT PREVENTS RECONVERSION, DO NOT REMOVE
"a" = (
/turf/open/floor/rogue/greenstone,
/area/rogue/under/town/sewer)
"b" = (
/obj/structure/spider/stickyweb,
/turf/open/floor/rogue/greenstone,
/area/rogue/under/town/sewer)
"d" = (
/obj/machinery/light/rogue/torchholder,
/turf/closed/wall/mineral/rogue/stonebrick,
/area/rogue/under/town/sewer)
"g" = (
/obj/effect/decal/cleanable/cobweb/cobweb2,
/turf/open/floor/rogue/greenstone,
/area/rogue/under/town/sewer)
"h" = (
/obj/structure/closet/crate/chest,
/obj/effect/spawner/lootdrop/roguetown/sewers,
/turf/open/floor/rogue/greenstone,
/area/rogue/under/town/sewer)
"l" = (
/obj/structure/glowshroom,
/turf/open/water/sewer,
/area/rogue/under/town/sewer)
"m" = (
/mob/living/carbon/human/species/human/northern/bum,
/turf/open/floor/rogue/greenstone,
/area/rogue/under/town/sewer)
"p" = (
/turf/closed/mineral/rogue,
/area/rogue/under/town/sewer)
"q" = (
/obj/structure/closet/crate/chest,
/obj/effect/spawner/lootdrop/roguetown/sewers,
/obj/effect/decal/cleanable/cobweb,
/turf/open/floor/rogue/greenstone,
/area/rogue/under/town/sewer)
"t" = (
/obj/structure/glowshroom,
/obj/structure/glowshroom,
/turf/open/floor/rogue/greenstone,
/area/rogue/under/town/sewer)
"v" = (
/obj/structure/spider/stickyweb,
/turf/open/water/sewer,
/area/rogue/under/town/sewer)
"C" = (
/obj/effect/decal/cleanable/blood,
/obj/effect/decal/cleanable/blood/tracks,
/obj/effect/decal/cleanable/blood/tracks,
/turf/closed/mineral/rogue,
/area/rogue/under/town/sewer)
"H" = (
/obj/structure/glowshroom,
/turf/open/floor/rogue/greenstone,
/area/rogue/under/town/sewer)
"I" = (
/turf/open/water/sewer,
/area/rogue/under/town/sewer)
"K" = (
/obj/effect/decal/cleanable/blood/tracks,
/turf/closed/mineral/rogue,
/area/rogue/under/town/sewer)
"N" = (
/turf/closed/wall/mineral/rogue/stonebrick,
/area/rogue/under/town/sewer)
"R" = (
/mob/living/simple_animal/hostile/retaliate/rogue/bigrat,
/obj/effect/decal/cleanable/cobweb,
/turf/open/floor/rogue/greenstone,
/area/rogue/under/town/sewer)
"S" = (
/obj/effect/decal/cleanable/blood/tracks,
/turf/closed/wall/mineral/rogue/stonebrick,
/area/rogue/under/town/sewer)
"V" = (
/mob/living/simple_animal/hostile/retaliate/rogue/bigrat,
/turf/open/floor/rogue/greenstone,
/area/rogue/under/town/sewer)
"W" = (
/mob/living/carbon/human/species/skeleton/npc,
/turf/open/floor/rogue/greenstone,
/area/rogue/under/town/sewer)

(1,1,1) = {"
p
p
p
p
p
p
p
p
p
p
p
p
p
p
p
p
p
p
p
N
"}
(2,1,1) = {"
p
p
p
p
p
p
p
p
p
p
p
p
p
p
p
p
p
p
p
N
"}
(3,1,1) = {"
p
p
p
p
p
p
p
p
p
p
p
p
p
p
p
p
p
p
p
N
"}
(4,1,1) = {"
p
p
N
N
N
N
N
N
N
N
N
N
N
N
N
N
N
N
N
N
"}
(5,1,1) = {"
p
p
N
R
a
a
a
a
a
a
a
m
a
a
a
a
a
a
V
a
"}
(6,1,1) = {"
p
p
N
a
I
I
I
I
I
I
I
I
I
I
v
I
I
I
l
I
"}
(7,1,1) = {"
p
p
N
b
v
b
a
a
a
H
t
I
a
a
b
b
a
m
H
a
"}
(8,1,1) = {"
p
p
N
a
I
a
N
N
N
N
N
I
N
N
N
N
N
N
N
N
"}
(9,1,1) = {"
p
p
N
a
I
a
N
p
p
p
N
I
N
p
p
p
p
p
p
N
"}
(10,1,1) = {"
p
p
N
m
I
a
N
p
p
p
N
I
N
p
p
p
p
p
p
N
"}
(11,1,1) = {"
p
p
N
a
I
a
N
p
p
p
N
I
N
p
p
p
p
p
p
N
"}
(12,1,1) = {"
p
p
N
a
I
a
N
p
p
p
N
I
N
p
p
p
p
p
p
N
"}
(13,1,1) = {"
C
K
S
a
I
a
N
p
N
N
N
I
N
N
N
p
p
p
p
N
"}
(14,1,1) = {"
p
p
N
a
I
a
N
p
N
q
a
I
a
a
N
p
p
p
p
N
"}
(15,1,1) = {"
p
p
N
a
l
a
N
p
N
h
a
I
a
W
N
p
p
p
p
N
"}
(16,1,1) = {"
p
p
N
H
I
a
N
N
N
a
H
l
a
a
N
N
N
N
N
N
"}
(17,1,1) = {"
p
p
N
a
I
I
I
I
I
I
I
l
I
I
I
I
I
I
I
I
"}
(18,1,1) = {"
p
p
N
a
I
a
N
N
N
a
b
v
a
a
N
N
N
N
N
N
"}
(19,1,1) = {"
p
p
N
a
v
a
N
p
N
a
a
v
a
a
N
p
p
p
p
N
"}
(20,1,1) = {"
p
p
N
b
v
a
N
p
N
g
a
I
V
a
N
p
p
p
p
N
"}
(21,1,1) = {"
p
p
N
a
I
a
N
p
N
N
N
I
N
N
N
p
p
p
p
N
"}
(22,1,1) = {"
p
p
N
a
I
m
N
p
p
p
N
I
N
p
p
p
p
p
p
N
"}
(23,1,1) = {"
p
p
N
a
I
a
N
p
p
p
N
I
N
p
p
p
p
p
p
N
"}
(24,1,1) = {"
p
p
N
a
I
a
N
p
p
p
N
I
N
p
p
p
p
p
p
N
"}
(25,1,1) = {"
p
p
N
V
I
H
N
p
p
p
N
I
N
p
p
p
p
p
p
N
"}
(26,1,1) = {"
d
N
N
a
I
a
N
N
N
N
N
I
N
N
N
N
N
N
N
N
"}
